30	30
50	50	50	50	50	50	50	50	50	50	50	50	50	50	50	50	50	50	50	50	50	50	50	50	50	50	20	20	20	2	
50	50	50	50	50	50	50	50	50	50	50	50	50	50	50	50	50	50	50	50	50	50	50	20	20	50	20	50	20	2	
50	50	50	50	50	50	50	50	50	50	50	50	50	50	50	50	50	50	50	50	50	50	50	20	20	50	20	50	20	2	
50	50	50	1	2	50	50	50	50	50	50	50	50	50	50	50	50	50	50	50	50	50	50	20	20	50	20	50	20	2	
50	50	1	2	2	50	50	50	50	50	50	50	50	50	50	50	50	50	50	50	50	50	50	20	20	50	50	50	50	2	
50	50	2	2	50	50	50	50	50	50	50	50	50	50	50	50	50	50	50	50	50	50	50	20	20	20	20	20	20	2	
50	50	36	50	50	50	50	50	50	50	50	50	50	50	50	50	50	50	50	50	50	50	50	36	41	50	50	50	50	2	
50	50	50	50	50	50	50	50	50	50	50	50	50	50	50	50	50	50	50	50	50	50	50	20	50	20	50	20	20	20	
50	50	50	50	50	50	50	50	50	50	50	50	50	50	50	50	50	50	50	50	20	20	20	20	50	20	50	50	50	2	
50	50	50	50	50	50	50	50	50	50	50	50	50	50	50	50	50	50	50	50	20	50	50	50	50	20	50	20	20	20	
50	50	50	50	50	50	50	50	50	50	50	50	50	50	50	50	50	50	50	50	20	50	20	20	20	20	50	20	20	2	
50	50	50	50	50	50	50	50	50	50	50	50	50	50	50	50	50	50	50	50	50	50	20	50	50	50	50	20	50	2	
50	50	50	50	50	50	50	50	50	50	50	50	50	50	50	50	50	50	50	50	20	50	20	39	20	20	20	20	20	2	
50	50	50	50	50	50	50	50	50	50	50	50	50	50	50	50	50	50	20	20	20	20	20	50	50	50	50	50	50	2	
50	50	50	50	50	50	50	50	50	50	0	0	0	50	50	50	50	50	20	50	50	50	20	10	10	10	50	20	20	2	
50	50	50	50	50	50	50	50	50	50	0	0	0	50	50	50	50	50	20	50	20	50	20	20	50	50	50	20	50	2	
50	50	50	50	0	50	50	50	50	50	0	0	0	50	50	50	50	50	20	50	20	50	50	20	20	20	20	20	50	2	
50	50	50	50	50	50	50	50	50	50	50	50	50	50	50	50	20	20	20	50	20	50	50	20	50	50	50	20	50	2	
50	50	50	50	50	50	50	50	50	50	50	50	50	50	50	50	20	50	50	50	20	50	50	20	50	20	50	20	50	2	
50	50	50	50	50	50	50	50	50	50	50	50	50	50	50	50	20	50	50	20	20	50	50	20	50	20	50	20	50	2	
50	50	50	50	50	50	50	50	50	50	50	50	20	20	20	20	20	50	50	20	20	50	50	50	50	20	50	20	20	2	
50	50	50	50	50	50	50	50	50	50	50	50	20	50	50	50	50	50	50	50	20	50	50	20	50	20	50	50	20	2	
50	50	50	50	50	50	50	50	50	50	50	50	20	50	20	20	20	20	20	50	20	50	50	20	50	20	50	50	20	2	
50	50	50	50	50	50	50	50	50	50	50	50	20	50	50	50	50	50	20	50	20	50	50	20	50	20	50	50	20	2	
50	50	50	50	50	50	50	50	50	50	50	50	20	20	20	50	50	50	20	50	20	50	50	20	20	20	50	20	20	2	
50	50	50	50	50	50	50	50	50	20	20	50	50	50	20	50	20	20	20	50	20	50	50	20	50	50	50	50	50	2	
50	50	50	50	50	50	50	50	50	20	50	20	20	50	20	50	20	50	50	50	20	50	50	20	50	20	20	20	50	20	
50	50	50	50	50	50	50	50	50	50	50	20	50	50	20	50	20	50	50	20	20	20	20	20	50	20	50	20	50	2	
50	50	50	50	50	50	50	50	50	20	20	20	50	50	50	50	20	50	50	20	50	50	50	50	50	20	50	20	50	2	
50	50	50	50	50	50	50	50	50	50	50	50	50	50	50	50	20	20	50	20	50	50	50	20	50	50	50	20	50	2	
END
1	1	1	1	1	1	1	1	1	1	1	1	1	1	1	1	1	1	1	1	1	1	1	1	1	1	0	0	0	1	
1	1	1	1	1	1	1	1	1	1	1	1	1	1	1	1	1	1	1	1	1	1	1	0	0	1	0	1	0	1	
1	1	1	1	1	1	1	1	1	1	1	1	1	1	1	1	1	1	1	1	1	1	1	0	0	1	0	1	0	1	
1	1	1	0	1	1	1	1	1	1	1	1	1	1	1	1	1	1	1	1	1	1	1	0	0	1	0	1	0	1	
1	1	0	1	1	1	1	1	1	1	1	1	1	1	1	1	1	1	1	1	1	1	1	0	0	1	1	1	1	1	
1	1	1	1	1	1	1	1	1	1	1	1	1	1	1	1	1	1	1	1	1	1	1	0	0	0	0	0	0	1	
1	1	1	1	1	1	1	1	1	1	1	1	1	1	1	1	1	1	1	1	1	1	1	1	1	1	1	1	1	1	
1	1	1	1	1	1	1	1	1	1	1	1	1	1	1	1	1	1	1	1	1	1	1	0	1	0	1	0	0	0	
1	1	1	1	1	1	1	1	1	1	1	1	1	1	1	1	1	1	1	1	0	0	0	0	1	0	1	1	1	1	
1	1	1	1	1	1	1	1	1	1	1	1	1	1	1	1	1	1	1	1	0	1	1	1	1	0	1	0	0	0	
1	1	1	1	1	1	1	1	1	1	1	1	1	1	1	1	1	1	1	1	0	1	0	0	0	0	1	0	0	1	
1	1	1	1	1	1	1	1	1	1	1	1	1	1	1	1	1	1	1	1	1	1	0	1	1	1	1	0	1	1	
1	1	1	1	1	1	1	1	1	1	1	1	1	1	1	1	1	1	1	1	0	1	0	0	0	0	0	0	0	1	
1	1	1	1	1	1	1	1	1	1	1	1	1	1	1	1	1	1	0	0	0	0	0	1	1	1	1	1	1	1	
1	1	1	1	1	1	1	1	1	1	0	0	0	1	1	1	1	1	0	1	1	1	0	0	0	0	1	0	0	1	
1	1	1	1	1	1	1	1	1	1	0	0	0	1	1	1	1	1	0	1	0	1	0	0	1	1	1	0	1	1	
1	1	1	1	0	1	1	1	1	1	0	0	0	1	1	1	1	1	0	1	0	1	1	0	0	0	0	0	1	1	
1	1	1	1	1	1	1	1	1	1	1	1	1	1	1	1	0	0	0	1	0	1	1	0	1	1	1	0	1	1	
1	1	1	1	1	1	1	1	1	1	1	1	1	1	1	1	0	1	1	1	0	1	1	0	1	0	1	0	1	1	
1	1	1	1	1	1	1	1	1	1	1	1	1	1	1	1	0	1	1	0	0	1	1	0	1	0	1	0	1	1	
1	1	1	1	1	1	1	1	1	1	1	1	0	0	0	0	0	1	1	0	0	1	1	1	1	0	1	0	0	1	
1	1	1	1	1	1	1	1	1	1	1	1	0	1	1	1	1	1	1	1	0	1	1	0	1	0	1	1	0	1	
1	1	1	1	1	1	1	1	1	1	1	1	0	1	0	0	0	0	0	1	0	1	1	0	1	0	1	1	0	1	
1	1	1	1	1	1	1	1	1	1	1	1	0	1	1	1	1	1	0	1	0	1	1	0	1	0	1	1	0	1	
1	1	1	1	1	1	1	1	1	1	1	1	0	0	0	1	1	1	0	1	0	1	1	0	0	0	1	0	0	1	
1	1	1	1	1	1	1	1	1	0	0	1	1	1	0	1	0	0	0	1	0	1	1	0	1	1	1	1	1	1	
1	1	1	1	1	1	1	1	1	0	1	0	0	1	0	1	0	1	1	1	0	1	1	0	1	0	0	0	1	0	
1	1	1	1	1	1	1	1	1	1	1	0	1	1	0	1	0	1	1	0	0	0	0	0	1	0	1	0	1	1	
1	1	1	1	1	1	1	1	1	0	0	0	1	1	1	1	0	1	1	0	1	1	1	1	1	0	1	0	1	1	
1	1	1	1	1	1	1	1	1	1	1	1	1	1	1	1	0	0	1	0	1	1	1	0	1	1	1	0	1	1	
END
